1111111111111111111111111111111111
1E0000000011000C00000C000000000001
1000000000110000000000000000000001
1000000000110000000000000000000001
100000000C00C000000000000000111111
1E0000000000000C00000C000000000001
1000000000000000000000110000000001
1000111100000000000000110000000001
1000P0000C00C0000000001100000000C1
1111111111111111111111111111111111
