1111111111111111111111111111111111
1000000000110000000000000000000001
1000000000110000000000000000000001
10000000001100000000000000000CC001
1000000000000000000000000000111111
1000000000000000000000000000000001
10000C0000000000000000110000000001
1000111100000000000000110000000001
1000000000000000000000110000000001
1000000000110000000000000000000001
1000000000110000000000000000000001
1000000000110000000000000000000001
1000000000000000000000000000111111
1000000000000000000000000000000001
10000CC000000000000000110000000001
1000111100000000000000110000000001
1000000000000000000000110000000001
1000000000110000000000000000000001
1000000000110000000000000000000001
1000000000110000000000000000000001
1000000000000000000000000000000001
1000000000000000000000M0CCCCCC0001
10000CC000000000000000111111111111
1000111100000000000000111111111111
1EMMP00000M0000M000000111111111111
1111111111111111111111111111111111
