1111111111111111111111111111111111
1E0000000011000C00000C000000000001
1000000000110000000000000000000001
1000000000110000000000000000000001
100000000C00C000000000000000111111
1E0000000000000C00000C000000000001
1000P00000000000000000110000000001
1000111100000000000000110000000001
10000000C00C00000001001100000000C1
1111111111111111111111111111111111
