11111111111111111111111111111111111111111111111111
100000000011000C00000C0000000000000000000000000001
10000000001100000000000000000000000000000000000001
10000000001100000000000000000000000000000000000001
100000000C00C0000000000000001111100000000000000001
100000000000000C00000C0000000000000000000000000001
10000000000000000000001100000000000000000000000001
10001111000000000000001100000000000000000000000001
100000000C00C0000000001100000000C00000000000000001
100000000011000C00000C0000000000000000000000000001
10000000001100000000000000000000000000000000000001
10000000001100000000000000000000000000000000000001
100000000C00C0000000000000001111100000000000000001
100000000000000C00000C0000000000000000000000000001
10000000000000000000001100000000000000000000000001
10001111000000000000001100000000000000000000000001
100000000C00C0000000001100000000C00000000000000001
10000000001100000000000000000000000000000000000001
100000000C00C0000000000000001111100000000000000001
100000000000000C00000C0000000000000000000000000001
10000000000000000000001100000000000000000000000001
10001111000000000000001100000000000000000000000001
100000000C00C0000000001100000000C00000000000000001
100000000011000C00000C0000000000000000000000000001
10000000001100000000000000000000000000000000000001
10000000001100000000000000000000000000000000000001
100000000C00C0000000000000000000000000000000000001
100000000000000C00000C0000000000000000000000000001
10000000000000000000000000000000000000000000000001
10000000001100000000000000000000000000000000000001
100000000C00C0000000000000000000000000000000000001
1C0000000000000C00000C0000000000000000000000000001
10000000000000000000001111111111100000000000000001
10001111000000000000001111111111100000110000000001
1E0P00000C00C0000000001111111111100000110000000001
11111111111111111111111111111111111111111111111111